; 01
■■■■■■■■■■■■■■■■■■■■■
■　　　　　　　　　　　　　　　　　　　■
■　　　　　　　　　　　　　　　　　　　■
■　　■　■　■　■■■■■■■■　　　■
■　　　　　　　　　　　　　　　　　　　■
■　ST　　　　　　　　　　　　　　　　　■
■　　　　　　　　　　　　　　■■■　　■
■　　　　　　　　　　　　　　■■■　　■
■　　　　　　　　　　　■■■■■■　　■
■　　　　　　　　　　　　　　　　　　　■
■■■■■　　　　　　　　　　　　　　　■
■■■■■■■■■　　　　　　　　　　　■
■■■■■■■■■　　　■■　　　　　　■
■■■■■■■■■　　　■■　　　　GL　■
■■■■■■■■■■■■■■■■■■■■■

; ----
; ----

; 02
